R 800 800
F 100,100,100
C 0,0,1

NO  pics/NO.xpm
SO  pics/SO.xpm
EA  pics/EA.xpm
WE  pics/WE.xpm
S   pics/small_shrek.xpm




                       1
                      111
                     11211
                    1120211
                   112000211
                  11200000211
                 1120000000211
                112000000000211
               11200000000000211
              112000000N000000211
             112000000000000000211
            11200000000000000000211
           1122222222222222222222211
          111111111111111111111111111