R 1920 1080
F 100,100,100
C 0,0,1

NO  pics/NO.xpm
SO  pics/SO.xpm
EA  pics/EA.xpm
WE  pics/WE.xpm
S   pics/small_shrek.xpm


                       1
                      111
                     11011
                    1100011
                   110000011
                  11000000011
                 1100000000011
                110000000000011
               11000000000000011
              110000000N000000011
             110000000000000000011
            11000000000000000000011
           1100000000000000000000011
          111111111111111111111111111