R     1366 768
NO               ./img/NO.xpm 
SO           ./img/SO.xpm
WE          ./img/WE.xpm

EA    ./img/EA.xpm

S     ./img/linus.xpm




F 238,130,238

C 0,191,255


1111
1001
1111