R      1366 768
NO               ./img/NO.xpm 
SO           ./img/SO.xpm
WE          ./img/WE.xpm

EA    ./img/EA.xpm

S     ./img/linus.xpm




F 238,130,238

C 0,191,255


        1111111111111111111111111
        1000000000110200000000001
        1001000000000000000000W01
        1000000000110200000000001
000111111111011000001110000000001111
000100000000011000001110111100111111
00011110111111111011100000010001
00011110111111111011101010010101
00011000002110101011100000010001
00010002000000000001101010010001
0001120000111010101111101111000111000000000000000
00011110111 1110101 101111010001
00011111111 1111111 111111111111