R     1280 720
NO               ./img/stone.xpm 
SO           ./img/metal.xpm
WE          ./img/wood.xpm

EA    ./img/brick.xpm

S     ./pics/wtc.xpm

F 238,130,238

C 0,191,255

1111111111111111111111111111111111
1222222222222222222222222222222221
1200000000000000000000000000000E21
1222222222222222222222222222222221
1111111111111111111111111111111111