R       1920             1080
NO               ./path_to_the_north_texture   
SO           ./path_to_the_south_texture
WE          ./path_to_the_west_texture

EA    ./path_to_the_east_texture

S     ./path_to_the_sprite_texture




F 220,100,0

C 80,80,80


1111111111111111111111111111111111111111111
1000000000000000000000000000000000000000001
1000000000000000020000000000000000000000001
1000000000000000000000000000000000000000001
1000000000000000000000000000000000000000001
1000000200000000000000000000000000000000001
1000000000000000000000000000000000000000001
1000000000000000000000000000000000000000001
1000000000000000000000000000000000000000001
1000000000000000000000000000000000000000001
1000000000000000000000000111111111111111111
10000000000000000000000001
1000002000000000000000N001
10000000000000000000000001
10000000000000000000000001
10000000000000000000000001
10000000000000000000000001
10000000000000000000000001
10000000000000000000000001
10000000000000000000000001
10000000000000000000000001
11111111111111111111111111