R    144 144
NO               ./img/stone.xpm 
SO           ./img/metal.xpm
WE          ./img/wood.xpm

EA    ./img/brick.xpm

S     ./pics/shrek.xpm

F 238,130,238

C 0,191,255

        1111111111111111111111111
        1000000000110020000020001
        1011000001110000002002001
        1001000000000000000000001
111111111011000001110020000000001
100000000011000001110111111011111
11110111111111011100000010001
11110111111111011101010010001
11000000110101011100000010001
10002000000000001100000010001
10000000000000001101010010001
11000001110101011111011110N0111
11110111 1110101 101111010001
11111111 1111111 111111111111