R       1920             1080
NO               ./maps/brick.xpm 
SO           ./maps/grass.xpm
WE          ./maps/metal.xpm

EA    ./maps/wood.xpm

S     ./maps/stone.xpm




F 220,100,0

C 80,80,80


        1111111111111111111111111
        1000000000110000000000001
        1011000001110000002000001
        1001000000000000000000001
000111111111011000001110000000001111
000100000000011000001110111100111111
00011110111111111011100000010001
00011110111111111011101010010001
00011000000110101011100000010001
00010002000000000001100000010001
00010000000000000001101010010001
00011000001110101011111011110N0111000000000000000
00011110111 1110101 101111010001
00011111111 1111111 111111111111