R       1280             720
NO               ./path_to_the_north_texture   
SO           ./path_to_the_south_texture
WE          ./path_to_the_west_texture

EA    ./path_to_the_east_texture

S     ./path_to_the_sprite_texture




F 220,100,0

C 225,30,0




        1111111111111111111111111
        1000000000110000000000001
        1011000001110000002000001
        1001000000000000000000001
000111111111011000001110000000001111
000100000000011000001110111111111111
00011110111111111011100000010001
00011110111111111011101010010001
00011000000110101011100000010001
00010002000000000001100000010001
00010000000000000001101010010001
00011000001110101011111011110N0111000000000000000
00011110111 1110101 101111010001
000011111111 1111111 111111111111
