R      1366 768
NO               ./img/brick.xpm 
SO           ./img/grass.xpm
WE          ./img/wood.xpm

EA    ./img/metal.xpm

S     ./img/linus.xpm




F 238,130,238

C 0,191,255


        1111111111111111111111111
        10000E0000110000000000001
        1011000001110000002000001
        1001000000000000000000001
000111111111011000001110000000001111
000100000000011000001110111100111111
00011110111111111011100000010001
00011110111111111011101010010101
00011000000110101011100000010001
00010002000000000001100000010001
00010000000000000001101010010001
0001100000111010101111101111000111000000000000000
00011110111 1110101 101111010001
00011111111 1111111 111111111111