R   1366  768
NO               ./img/stone.xpm 
SO           ./img/metal.xpm
WE          ./img/wood.xpm


EA    ./img/brick.xpm

S     ./pics/shrek.xpm

F 238,130,238

C 0,191,255

11111111111111111111111111111111111111111
12222222222222222222222222222222222222221
1E000000000000000000000000000000000000021
12222222222222222222222222222222222222221
11111111111111111111111111111111111111111